1111111111111111
10010000000C0001
1000011011001C01
1P0011E00000C001
1001000000000001
1000000000C00001
1000000000000001
10000000C0000001
10010000C0000001
10000000C0000001
10000000C00C0001
1001000000000001
1000000000000001
1111111111111111
