1111111111111111
10010000000C0001
1000011111001C01
1P0011E00000C001
1111111111111111
